10 10 10 10 10 10 10 10 10 10 10 10 10 10 10 10 10 10 10 10 10 10 10 10 10 10 10 10 10 10 10 10 10 10 10 10 10 10 10 10 10 10 10 10 10 10 10 10 10 10 10 10 10 10 10 10 10 10 10 10 10 10
10 0 0 0 0 0 0 0 0 0 0 0 0 0 0 0 0 0 0 0 0 0 0 0 0 0 0 0 0 0 0 0 0 0 0 0 0 0 0 0 0 0 0 0 0 0 0 0 0 0 0 0 0 0 0 0 0 0 0 0 0 10
10 0 0 0 0 0 0 0 0 0 0 0 0 0 0 0 0 0 0 0 0 0 0 0 0 0 0 0 0 0 0 0 0 0 0 0 0 0 0 0 0 0 0 0 0 0 0 0 0 0 0 0 0 0 0 0 0 0 0 0 0 10
10 0 0 0 0 0 0 3 3 3 0 0 0 0 0 0 0 0 0 0 0 0 0 0 0 0 0 0 0 0 0 0 0 0 0 0 0 0 0 0 0 0 0 0 0 0 0 0 0 0 0 0 8 8 8 0 0 0 0 0 0 10
10 0 0 0 0 0 0 3 3 3 0 0 7 7 7 0 0 0 0 0 0 0 0 0 0 0 0 0 0 0 0 0 0 0 0 0 0 0 0 0 0 0 0 0 0 0 0 0 0 0 0 0 3 3 3 0 0 0 0 0 0 10
10 0 0 0 0 0 0 3 3 3 0 0 7 7 7 0 0 0 0 0 0 0 0 0 0 0 0 0 0 0 0 0 0 0 0 0 0 0 0 0 0 0 0 0 0 0 0 0 0 0 0 0 3 3 3 0 0 0 0 0 0 10
10 0 0 0 0 0 0 3 3 3 0 0 0 0 0 0 0 3 3 3 0 3 3 3 0 0 0 0 3 3 3 0 0 0 3 3 3 0 0 3 3 3 0 0 0 0 0 3 3 3 0 0 2 2 2 0 0 0 0 0 0 10
10 0 0 0 0 0 0 3 3 3 0 0 3 3 3 0 0 3 3 3 0 0 0 3 3 3 0 0 3 3 3 0 0 0 3 3 3 0 0 0 3 3 3 0 0 0 3 3 3 0 0 0 2 2 2 0 0 0 0 0 0 10
10 0 0 0 0 0 0 3 3 3 0 0 3 3 3 0 0 3 3 3 0 0 0 3 3 3 0 0 3 3 3 0 0 0 3 3 3 0 0 0 0 3 3 3 0 3 3 3 0 0 0 0 1 1 1 0 0 0 0 0 0 10
10 0 0 0 0 0 0 3 3 3 0 0 3 3 3 0 0 3 3 3 0 0 0 3 3 3 0 0 3 3 3 0 0 0 3 3 3 0 0 0 0 0 0 3 3 3 0 0 0 0 0 0 1 1 1 0 0 0 0 0 0 10
10 0 0 0 0 0 0 3 3 3 0 0 3 3 3 0 0 3 3 3 0 0 0 3 3 3 0 0 3 3 3 0 0 0 3 3 3 0 0 0 0 3 3 3 0 3 3 3 0 0 0 0 0 0 0 0 0 0 0 0 0 10
10 0 0 0 0 0 0 3 3 3 0 0 3 3 3 0 0 3 3 3 0 0 0 3 3 3 0 0 3 3 3 0 0 0 3 3 3 0 0 0 3 3 3 0 0 0 3 3 3 0 0 0 7 7 7 0 0 0 0 0 0 10
10 0 0 0 0 0 0 3 3 3 0 0 3 3 3 0 0 3 3 3 0 0 0 3 3 3 0 0 0 0 3 3 3 0 3 3 3 0 0 3 3 3 0 0 0 0 0 3 3 3 0 0 7 7 7 0 0 0 0 0 0 10
10 0 0 0 0 0 0 8 8 8 0 0 8 8 8 0 0 8 8 8 0 0 0 8 8 8 0 0 0 0 8 8 8 0 8 8 8 0 0 8 8 8 0 0 0 0 0 8 8 8 0 0 8 8 8 0 0 0 0 0 0 10
10 0 0 0 0 0 0 0 0 0 0 0 0 0 0 0 0 0 0 0 0 0 0 0 0 0 0 0 0 0 0 0 0 0 0 0 0 0 0 0 0 0 0 0 0 0 0 0 0 0 0 0 0 0 0 0 0 0 0 0 0 10
10 0 0 0 0 0 0 0 0 0 0 0 0 0 0 0 0 0 0 0 0 0 0 0 0 0 0 0 0 0 0 0 0 0 0 0 0 0 0 0 0 0 0 0 0 0 0 0 0 0 0 0 0 0 0 0 0 0 0 0 0 10
10 0 0 0 0 0 0 0 0 0 0 0 0 0 0 0 0 0 0 0 0 0 0 0 0 0 0 0 0 0 0 0 0 0 0 0 0 0 0 0 0 0 0 0 0 0 0 0 0 0 0 0 0 0 0 0 0 0 0 0 0 10
10 0 0 0 0 0 0 0 0 0 0 0 0 0 0 0 0 0 0 0 0 0 0 0 0 0 0 0 0 0 0 0 0 0 0 0 0 0 0 0 0 0 0 0 0 0 0 0 0 0 0 0 0 0 0 0 0 0 0 0 0 10
10 0 0 0 0 0 0 0 0 0 0 0 0 0 0 0 0 0 0 0 0 0 0 0 0 0 0 0 0 0 0 0 0 0 0 0 0 0 0 0 0 0 0 0 0 0 0 0 0 0 0 0 0 0 0 0 0 0 0 0 0 10
10 0 0 0 0 0 0 0 0 0 0 0 0 0 0 0 0 0 0 0 0 0 0 0 0 0 0 0 0 0 0 0 0 0 0 0 0 0 0 0 0 0 0 0 0 0 0 0 0 0 0 0 0 0 0 0 0 0 0 0 0 10
10 0 0 0 0 0 0 0 0 0 0 0 0 0 0 0 0 0 0 0 0 0 0 0 0 0 0 0 0 0 0 0 0 0 0 0 0 0 0 0 0 0 0 0 0 0 0 0 0 0 0 0 0 0 0 0 0 0 0 0 0 10
10 11 11 11 11 11 11 11 11 11 11 11 11 11 11 11 11 11 11 11 11 11 11 11 11 11 11 11 11 11 11 11 11 11 11 11 11 11 11 11 11 11 11 11 11 11 11 11 11 11 11 11 11 11 11 11 11 11 11 11 11 10
